##################################################
#                     #    #        #            >
#       #   ######  # #    #        ###          #
#       #           # #    #  #       #          #
<   #   #         # #   #  #  #       #          >
#   #   #      ####     #  #  #                  #
#   #           # #     #  #  #                  #
#                       #     #                  >
##################################################
