##################################################
#                     #             #            >
#       #             #             ###          #
#       #             #       #       #          #
<       #         #           #       #          >
#       #      ####           #                  #
#                             #                  #
#                             #                  >
##################################################
