##################################################
#                     #               #          >
#       #     #                  #  ###          #
#             #       #    #     #               #
<       #             #    #     #               >
### #####       #### ##    #          #          #
#                     #          #    #          #
#                         ##          #          >
##################################################
